0011111111
1000010001
1010010101
1001010100
1001000110